adicarlo = Adam Di Carlo <adicarlo@users.sourceforge.net>
arayq2 = Arjun Ray <arayq2@users.sourceforge.net>
Avi = Avi <avi@users.sourceforge.net>
avi = Avi <avi@users.sourceforge.net>
bibach = Brandon Ibach <bibach@users.sourceforge.net>
clasen = Matthias Clasen <clasen@users.sourceforge.net>
complement = Petr Ovtchenkov <complement@users.sourceforge.net>
cristx = cristian tornador antolin <cristx@users.sourceforge.net>
debian = Debian <debian@users.sourceforge.net>
gershonj = Gershon Leib Joseph <gershonj@users.sourceforge.net>
hoehrmann = Björn Höhrmann <hoehrmann@users.sourceforge.net>
icastle = Ian Castle <icastle@users.sourceforge.net>
jfarreres = Javier Farreres <jfarreres@users.sourceforge.net>
jphekman = Jessica P. Hekman <jphekman@users.sourceforge.net>
keichwa = Karl Eichwalder <keichwa@users.sourceforge.net>
liamquinn = Liam Quinn <liamquinn@users.sourceforge.net>
magmouse = Nick Hunt <magmouse@users.sourceforge.net>
martind = Didier PH Martin <martind@users.sourceforge.net>
murray =  Murray Stokely <murray@users.sourceforge.net>
neilroeth = Neil Roeth <neilroeth@users.sourceforge.net>
nrkew = Nick Kew <nrkew@users.sourceforge.net>
phtyson = Paul H. Tyson <phtyson@users.sourceforge.net>
pnil = Peter N. Lundblad <pnil@users.sourceforge.net>
pn = Unknown <pn@users.sourceforge.net>
tbe = Terje Bless <tbe@users.sourceforge.net>
tonydodd = Tony Dodd <tonydodd@users.sourceforge.net>
traviss = Travis Spencer <traviss@users.sourceforge.net>
twaugh = Tim Waugh <twaugh@users.sourceforge.net>
(no author) = Unknown <foo@bar>
n648892 = David Nedrow <dnedrow@me.com>
